CodigoProduto;DescricaoProduto;UnidadeMedida;GradeEstoque;GradeCadastrada;Reserva;Saida;SaldoDisponivel
279;BRAHMA CHOPP LONG NECK 355ML SIX-PACK CAIXA C/4;Caixa;1;166;0;3;163
279;BRAHMA CHOPP LONG NECK 355ML SIX-PACK CAIXA C/4;Caixa;2;168;0;0;168
371;MALZBIER BRAHMA LONG NECK 355ML SIX-PACK BANDEJA C/4;Caixa;1;18;0;0;18
371;MALZBIER BRAHMA LONG NECK 355ML SIX-PACK BANDEJA C/4;Caixa;2;112;0;12;100
503;SUKITA PET 2L CAIXA C/6;Caixa;2;175;0;0;175
503;SUKITA PET 2L CAIXA C/6;Caixa;1;12;0;8;4
504;PEPSI COLA PET 2L CAIXA C/6;Caixa;2;1103;0;849;254
504;PEPSI COLA PET 2L CAIXA C/6;Caixa;1;275;0;32;243
772;PEPSI COLA MIX BAG IN BOX 18L;Litro;1;540;0;180;360
982;SKOL 600ML;Duzia;1;761;0;4;757
988;BRAHMA CHOPP 600ML;Duzia;1;518;0;279;239
988;BRAHMA CHOPP 600ML;Duzia;2;3;0;0;3
1166;SUKITA UVA PET 2L CAIXA C/6;Caixa;1;2;0;2;0
1166;SUKITA UVA PET 2L CAIXA C/6;Caixa;2;15;0;0;15
1388;SKOL GFA VD 1L 2,99;Duzia;1;30;0;0;30
1493;ANTARCTICA PILSEN LATA 350ML SH C/18 NPAL PACK PRICE;Caixa;1;1;0;0;1
1695;BRAHMA CHOPP GFA VD 1L COM TTC;Duzia;1;1457;0;165;1292
1695;BRAHMA CHOPP GFA VD 1L COM TTC;Duzia;2;29;0;0;29
1699;STELLA ARTOIS LT 269ML CX C/8 FRIDGE PACK;Caixa;1;22;0;16;6
1699;STELLA ARTOIS LT 269ML CX C/8 FRIDGE PACK;Caixa;2;121;0;60;61
1743;ANTARCTICA PILSEN GFA VD 1L COM TTC;Duzia;2;48;0;20;28
1743;ANTARCTICA PILSEN GFA VD 1L COM TTC;Duzia;1;3330;0;109;3221
1745;SKOL LT 269ML SH C15 NPAL;Caixa;2;35056;0;133;34923
1745;SKOL LT 269ML SH C15 NPAL;Caixa;1;6519;0;36;6483
1898;BRAHMA CHOPP LT 269ML SH C15 NPAL;Caixa;2;68915;0;1826;67089
1898;BRAHMA CHOPP LT 269ML SH C15 NPAL;Caixa;1;65456;0;507;64949
2132;GUARANA CHP ANTARCTICA PET 1L CAIXA C/6 NOVA RIO;Caixa;2;345;0;0;345
2132;GUARANA CHP ANTARCTICA PET 1L CAIXA C/6 NOVA RIO;Caixa;1;531;0;23;508
2243;GUARANA CHP ANTARCTICA MIX BAG IN BOX 18L;Litro;1;90;0;72;18
2250;GUARANA CHP ANTARCTICA DIET MIX BAG IN BOX 18L;Litro;1;486;0;54;432
2349;GUARANA CHP ANTARCTICA PET 2L CAIXA C/6;Caixa;2;9857;0;535;9322
2349;GUARANA CHP ANTARCTICA PET 2L CAIXA C/6;Caixa;1;5559;0;2334;3225
2350;SODA LIMONADA ANTARCTICA PET 2L CAIXA C/6;Caixa;1;162;0;3;159
2350;SODA LIMONADA ANTARCTICA PET 2L CAIXA C/6;Caixa;2;641;0;241;400
2353;GUARANA CHP ANTARCTICA DIET PET 2L CAIXA C/6;Caixa;2;656;0;0;656
2353;GUARANA CHP ANTARCTICA DIET PET 2L CAIXA C/6;Caixa;1;96;0;19;77
2354;SODA LIMONADA ANTARCTICA DIET PET 2L CAIXA C/6;Caixa;1;9;0;2;7
2357;BARE GUARANA PET 2L CAIXA C/6;Caixa;1;434;0;29;405
2357;BARE GUARANA PET 2L CAIXA C/6;Caixa;2;807;0;77;730
2538;ANTARCTICA PILSEN 600ML;Duzia;1;868;0;112;756
2538;ANTARCTICA PILSEN 600ML;Duzia;2;17;0;0;17
2546;ORIGINAL 600ML;Duzia;1;219;0;217;2
2546;ORIGINAL 600ML;Duzia;2;99;0;84;15
2548;BUDWEISER 600ML;Duzia;1;482;0;6;476
2548;BUDWEISER 600ML;Duzia;2;187;0;0;187
3733;BOHEMIA NOVA EMBALAGEM 600ML;Duzia;1;1;0;0;1
4141;PATAGONIA AMB LAG NACIONAL LT SLEEK 350ML C 8 CX CARTAO;Caixa;2;407;0;56;351
4141;PATAGONIA AMB LAG NACIONAL LT SLEEK 350ML C 8 CX CARTAO;Caixa;1;16;0;0;16
4193;PATAGONIA WEISSE NACIONAL LT SLEEK 350ML C 8 CX CARTAO;Caixa;2;451;0;0;451
4193;PATAGONIA WEISSE NACIONAL LT SLEEK 350ML C 8 CX CARTAO;Caixa;1;30;0;0;30
4198;PATAGONIA IPA LT SLEEK 350ML C 8 CX CARTAO;Caixa;1;1;0;1;0
4198;PATAGONIA IPA LT SLEEK 350ML C 8 CX CARTAO;Caixa;2;35;0;0;35
4293;PEPSI BLACK PET 200ML SH C/12;Caixa;2;3148;0;614;2534
4293;PEPSI BLACK PET 200ML SH C/12;Caixa;1;432;0;7;425
4359;INDAIA AGUA MINERAL C/GAS GFA PET 1,5L FD C/6;Caixa;1;874;0;4;870
4359;INDAIA AGUA MINERAL C/GAS GFA PET 1,5L FD C/6;Caixa;2;1311;0;32;1279
4367;INDAIA AGUA MINERAL S/GAS GFA PET 1,5L FD C/6;Caixa;1;1114;0;14;1100
4367;INDAIA AGUA MINERAL S/GAS GFA PET 1,5L FD C/6;Caixa;2;1672;0;30;1642
4409;PEPSI TWIST PET 2L SHRINK C/6;Caixa;2;584;0;202;382
4409;PEPSI TWIST PET 2L SHRINK C/6;Caixa;1;135;0;4;131
7431;SUKITA MIX BAG IN BOX 18L;Litro;1;324;0;72;252
7947;GUARANA CHP ANTARCTICA PET 2,5L CAIXA C/6;Caixa;2;944;0;78;866
7947;GUARANA CHP ANTARCTICA PET 2,5L CAIXA C/6;Caixa;1;339;0;7;332
7977;GATORADE UVA PET 500ML SIXPACK;Caixa;1;193;0;151;42
7977;GATORADE UVA PET 500ML SIXPACK;Caixa;2;1280;0;527;753
7979;GATORADE FRUTAS CITRICAS PET 500ML SIXPACK;Caixa;2;30;0;24;6
7979;GATORADE FRUTAS CITRICAS PET 500ML SIXPACK;Caixa;1;20;0;5;15
7981;GATORADE LARANJA PET 500ML SIXPACK;Caixa;2;7977;0;546;7431
7981;GATORADE LARANJA PET 500ML SIXPACK;Caixa;1;1238;0;74;1164
7982;GATORADE LIMAO PET 500ML SIXPACK;Caixa;2;6268;0;1099;5169
7982;GATORADE LIMAO PET 500ML SIXPACK;Caixa;1;764;0;158;606
7985;GATORADE MARACUJA PET 500ML SIXPACK;Caixa;2;1364;0;329;1035
8411;GUARANA CHP ANTARCTICA PET 1,5 SHRINK C/6;Caixa;2;3014;0;751;2263
8411;GUARANA CHP ANTARCTICA PET 1,5 SHRINK C/6;Caixa;1;473;0;24;449
8418;PEPSI COLA PET 1500 CX06;Caixa;1;0;0;0;0
8791;H2OH LIMAO C/GAS PET 500ML CAIXA C/12;Caixa;1;1;0;1;0
8793;H2OH LIMAO C/GAS PET 1,5L CAIXA C/6;Caixa;1;54;0;31;23
8793;H2OH LIMAO C/GAS PET 1,5L CAIXA C/6;Caixa;2;320;0;115;205
8919;GUARANA CHP ANTARCTICA PET 600ML CX12 NPAL;Caixa;2;74;0;11;63
8919;GUARANA CHP ANTARCTICA PET 600ML CX12 NPAL;Caixa;1;11;0;10;1
8921;GUARANA CHP ANTARCTICA DIET PET 600ML CX12 NPAL;Caixa;1;43;0;43;0
8921;GUARANA CHP ANTARCTICA DIET PET 600ML CX12 NPAL;Caixa;2;404;0;338;66
9067;ANTARCTICA PILSEN LATA 350ML SH C/12 NPAL;Caixa;2;14477;0;286;14191
9067;ANTARCTICA PILSEN LATA 350ML SH C/12 NPAL;Caixa;1;1555;0;18;1537
9068;SKOL LATA 350ML SH C/12 NPAL;Caixa;1;150;0;15;135
9068;SKOL LATA 350ML SH C/12 NPAL;Caixa;2;2228;0;44;2184
9069;BRAHMA CHOPP LATA 350ML SH C/12 NPAL;Caixa;1;814;0;16;798
9069;BRAHMA CHOPP LATA 350ML SH C/12 NPAL;Caixa;2;4460;0;110;4350
9081;MALZBIER BRAHMA LATA 350ML SH C/12 NPAL;Caixa;1;3;0;3;0
9081;MALZBIER BRAHMA LATA 350ML SH C/12 NPAL;Caixa;2;20;0;0;20
9084;GUARANA CHP ANTARCTICA LATA 350ML SH C/12 NPAL;Caixa;1;235;0;51;184
9084;GUARANA CHP ANTARCTICA LATA 350ML SH C/12 NPAL;Caixa;2;730;0;730;0
9085;GUARANA CHP ANTARCTICA DIET LATA 350ML SH C/12 NPAL;Caixa;2;11855;0;139;11716
9085;GUARANA CHP ANTARCTICA DIET LATA 350ML SH C/12 NPAL;Caixa;1;846;0;40;806
9087;SODA LIMONADA ANTARCTICA LATA 350ML SH C/12 NPAL;Caixa;1;1;0;0;1
9089;SUKITA LATA 350ML SH C/12 NPAL;Caixa;1;9;0;1;8
9089;SUKITA LATA 350ML SH C/12 NPAL;Caixa;2;0;0;0;0
9091;TONICA ANTARCTICA LATA 350ML SH C/12 NPAL;Caixa;1;10;0;0;10
9091;TONICA ANTARCTICA LATA 350ML SH C/12 NPAL;Caixa;2;0;0;0;0
9092;TONICA ANTARCTICA DIET LATA 350ML SH C/12 NPAL;Caixa;1;411;0;3;408
9092;TONICA ANTARCTICA DIET LATA 350ML SH C/12 NPAL;Caixa;2;23569;0;125;23444
9096;PEPSI COLA LATA 350ML SH C/12 NPAL;Caixa;2;46;0;0;46
9096;PEPSI COLA LATA 350ML SH C/12 NPAL;Caixa;1;11;0;4;7
9224;ANTARCTICA PILSEN LT 269ML SH TRANSP C/15 NPAL;Caixa;1;22558;0;359;22199
9224;ANTARCTICA PILSEN LT 269ML SH TRANSP C/15 NPAL;Caixa;2;57474;0;5816;51658
9259;SKOL LATA 350ML SH C/18 NPAL;Caixa;2;10;0;0;10
9259;SKOL LATA 350ML SH C/18 NPAL;Caixa;1;10;0;9;1
9274;PEPSI ZERO LATA 350ML SH C/12 NPAL;Caixa;2;0;0;0;0
9276;PEPSI ZERO PET 2L CAIXA C/6;Caixa;1;275;0;29;246
9276;PEPSI ZERO PET 2L CAIXA C/6;Caixa;2;1371;0;538;833
9320;BRAHMA CHOPP LT 473ML SH C/12 NPAL;Caixa;2;536;0;0;536
9320;BRAHMA CHOPP LT 473ML SH C/12 NPAL;Caixa;1;536;0;6;530
9442;PEPSI TWIST MIX BAG IN BOX 18L;Litro;1;450;0;36;414
9805;LEFFE BLONDE ONE WAY 330ML CX C/24;Caixa;2;202;0;0;202
9805;LEFFE BLONDE ONE WAY 330ML CX C/24;Caixa;1;65;0;0;65
9886;BRAHMA CHOPP LATA 350ML SH C/18 NPAL;Caixa;1;20;0;2;18
9886;BRAHMA CHOPP LATA 350ML SH C/18 NPAL;Caixa;2;20;0;0;20
10537;BOHEMIA GFA VD 990ML;Duzia;1;177;0;1;176
11190;LIPTON LIMAO PET 1,5 SHRINK C/6 HF;Caixa;2;147;0;29;118
11190;LIPTON LIMAO PET 1,5 SHRINK C/6 HF;Caixa;1;147;0;0;147
11191;LIPTON PESSEGO PET 1,5 SHRINK C/6 HF;Caixa;2;73;0;11;62
11191;LIPTON PESSEGO PET 1,5 SHRINK C/6 HF;Caixa;1;48;0;0;48
11503;ANTARCTICA SUBZERO LT 269ML SH C15 NPAL;Caixa;1;136;0;0;136
11503;ANTARCTICA SUBZERO LT 269ML SH C15 NPAL;Caixa;2;449;0;0;449
11518;SKOL ONE WAY 300ML CXPAP12;Caixa;1;39;0;1;38
12360;GUARANA ANTARCTICA ZERO LT 269ML SH C15 NPAL;Caixa;1;1;0;1;0
12360;GUARANA ANTARCTICA ZERO LT 269ML SH C15 NPAL;Caixa;2;62;0;10;52
12948;BRAHMA CHOPP ZERO LATA 350ML SH C/12 NPAL;Caixa;2;2057;0;1435;622
12948;BRAHMA CHOPP ZERO LATA 350ML SH C/12 NPAL;Caixa;1;1004;0;68;936
12951;BRAHMA CHOPP ZERO LN 355ML SIXPACK CX CART C/04;Caixa;1;23;0;4;19
12951;BRAHMA CHOPP ZERO LN 355ML SIXPACK CX CART C/04;Caixa;2;59;0;54;5
13061;H2OH LIMONETO PET 500ML SHRINK C/12 NPAL;Caixa;2;9535;0;620;8915
13061;H2OH LIMONETO PET 500ML SHRINK C/12 NPAL;Caixa;1;1310;0;108;1202
13065;H2OH LIMONETO PET 1,5 SHRINK C/06 NPAL;Caixa;1;334;0;46;288
13065;H2OH LIMONETO PET 1,5 SHRINK C/06 NPAL;Caixa;2;2069;0;127;1942
13194;BRAHMA CHOPP ONE WAY 300ML CX C/23;Caixa;1;381;0;21;360
13201;BRAHMA CHOPP GFA VD 300ML CX C/23;Caixa;1;322;0;304;18
13201;BRAHMA CHOPP GFA VD 300ML CX C/23;Caixa;2;126;0;20;106
13203;ANTARCTICA PILSEN GFA VD 300ML CX C/23;Caixa;1;570;0;270;300
13203;ANTARCTICA PILSEN GFA VD 300ML CX C/23;Caixa;2;32;0;20;12
13205;SKOL GFA VD 300ML CX C/23;Caixa;1;132;0;6;126
13205;SKOL GFA VD 300ML CX C/23;Caixa;2;48;0;0;48
13307;BUDWEISER GFA VD 990ML CX C/12;Caixa;1;1;0;0;1
13486;FUSION PET 1L SH C/06;Caixa;2;70;0;0;70
13486;FUSION PET 1L SH C/06;Caixa;1;64;0;0;64
13566;SKOL BEATS SENSES LT 269ML CX C/8 FRIDGE PACK;Caixa;2;385;0;377;8
13566;SKOL BEATS SENSES LT 269ML CX C/8 FRIDGE PACK;Caixa;1;88;0;0;88
14138;SKOL BEATS SENSES LATA 473ML SIX-PACK SH C/2 NPAL;Caixa;1;1;0;0;1
14340;ORIGINAL ONE WAY 300ML CXPAP12;Caixa;1;80;0;40;40
14340;ORIGINAL ONE WAY 300ML CXPAP12;Caixa;2;235;0;0;235
14550;COLORADO APPIA ONE WAY 600ML CX C-12 ARTE;Caixa;2;437;0;32;405
14550;COLORADO APPIA ONE WAY 600ML CX C-12 ARTE;Caixa;1;103;0;1;102
14552;COLORADO INDICA ONE WAY 600ML CX C-12 ARTE;Caixa;1;19;0;1;18
14552;COLORADO INDICA ONE WAY 600ML CX C-12 ARTE;Caixa;2;162;0;0;162
14554;COLORADO DEMOISELLE ONE WAY 600ML CX C-12 ARTE;Caixa;1;17;0;0;17
14556;COLORADO VIXNU ONE WAY 600ML CX C-12 ARTE;Caixa;1;7;0;1;6
14556;COLORADO VIXNU ONE WAY 600ML CX C-12 ARTE;Caixa;2;29;0;0;29
14842;PEPSI COLA LT 269ML SH C/15;Caixa;1;339;0;9;330
14842;PEPSI COLA LT 269ML SH C/15;Caixa;2;2530;0;1203;1327
14844;GUARANA CHP ANTARCTICA LT 269ML SH C/15;Caixa;2;4337;0;354;3983
14844;GUARANA CHP ANTARCTICA LT 269ML SH C/15;Caixa;1;274;0;18;256
17276;PATAGONIA AMB LAG NACIONAL LN 355ML CX C/12;Caixa;1;38;0;0;38
17276;PATAGONIA AMB LAG NACIONAL LN 355ML CX C/12;Caixa;2;324;0;7;317
17278;PATAGONIA WEISSE NACIONAL LN 355ML CX C/12;Caixa;1;6;0;0;6
17278;PATAGONIA WEISSE NACIONAL LN 355ML CX C/12;Caixa;2;46;0;0;46
17757;BECKS N LONG NECK 330ML SIX-PACK SHRINK C/4;Caixa;1;91;0;2;89
17757;BECKS N LONG NECK 330ML SIX-PACK SHRINK C/4;Caixa;2;198;0;4;194
17797;BRAHMA CHOPP LATA 350ML SH C/18 NPAL MULTPACK;Caixa;1;873;0;0;873
17808;BUDWEISER OW 330ML CX C/24;Caixa;2;2931;0;98;2833
17808;BUDWEISER OW 330ML CX C/24;Caixa;1;479;0;14;465
17874;WALS COCO BAMBU ONE WAY 600ML CX C/12 ARTE;Caixa;1;21;0;0;21
18135;SERRAMALTE LATA 350ML SIX-PACK SH C/2 NPAL;Caixa;2;255;0;0;255
18137;GUARANA CHP ANTARCTICA PET 3L C/04 SHRINK LISO;Caixa;1;15;0;4;11
18142;GOOSE ISLAND MIDWAY NAC LN 355ML CX C/12;Caixa;1;1;0;0;1
18152;GUARANA CHP ANTARCTICA PET 200ML SH C/12;Caixa;1;933;0;879;54
18152;GUARANA CHP ANTARCTICA PET 200ML SH C/12;Caixa;2;1886;0;270;1616
18266;PEPSI COLA PET 200ML SH C/12;Caixa;1;165;0;6;159
18266;PEPSI COLA PET 200ML SH C/12;Caixa;2;2059;0;473;1586
18267;SODA LIMONADA ANTARCTICA PET 200ML SH C/12;Caixa;2;18;0;0;18
18267;SODA LIMONADA ANTARCTICA PET 200ML SH C/12;Caixa;1;6;0;2;4
18268;SUKITA PET 200ML SH C/12;Caixa;2;254;0;102;152
18268;SUKITA PET 200ML SH C/12;Caixa;1;108;0;8;100
18341;PEPSI COLA PET 3000 ML C/04 SHRINK LISO .;Caixa;1;3;0;0;3
18390;GUARANA CHP ANTARCTICA LATA 350ML SH C/18 NPAL MULTPACK;Caixa;1;192;0;8;184
18390;GUARANA CHP ANTARCTICA LATA 350ML SH C/18 NPAL MULTPACK;Caixa;2;289;0;0;289
18750;PATAGONIA BOH PILS NACIONAL ONE WAY 740ML CX6;Caixa;2;477;0;0;477
18750;PATAGONIA BOH PILS NACIONAL ONE WAY 740ML CX6;Caixa;1;166;0;0;166
18752;PATAGONIA WEISSE NACIONAL ONE WAY 740ML CX6;Caixa;1;1;0;0;1
18772;PATAGONIA AMB LAG NACIONAL ONE WAY 740ML CX6;Caixa;1;21;0;0;21
18772;PATAGONIA AMB LAG NACIONAL ONE WAY 740ML CX6;Caixa;2;69;0;3;66
18780;CORONITA EXTRA N OW 210ML CX C/4 SIX PACK;Caixa;2;16775;0;14;16761
18780;CORONITA EXTRA N OW 210ML CX C/4 SIX PACK;Caixa;1;1431;0;62;1369
18807;STELLA ARTOIS LONG NECK 330ML SIX-PACK SHRINK C/4;Caixa;2;1912;0;4;1908
18807;STELLA ARTOIS LONG NECK 330ML SIX-PACK SHRINK C/4;Caixa;1;2032;0;186;1846
18836;CORONA EXTRA N LONG NECK 330ML CX C/24 NPAL;Caixa;1;1199;0;251;948
18836;CORONA EXTRA N LONG NECK 330ML CX C/24 NPAL;Caixa;2;1346;0;115;1231
18856;SKOL LT 269ML SH C/15 MULTPACK 15;Caixa;1;11561;11227;334;0
18858;ANTARCTICA PILSEN LT 269ML SH C/15 MULTPACK 15;Caixa;1;106;0;48;58
18860;BRAHMA CHOPP LT 269ML SH C/15 MULTPACK 15;Caixa;1;2;0;2;0
19164;GUARANA CHP ANTARCTICA PET 1L PACK C/2 MULTPACK;Caixa;1;702;0;381;321
19164;GUARANA CHP ANTARCTICA PET 1L PACK C/2 MULTPACK;Caixa;2;360;0;0;360
19225;RED BULL BR LATA 250ML CX C 24 NPAL .;Caixa;1;104;0;7;97
19227;RED BULL BR LATA 355ML FOUR PACK .;Caixa;1;7;0;0;7
19229;RED BULL BR LATA 250ML SIX PACK NPAL .;Caixa;1;888;0;13;875
19231;RED BULL SUGAR FREE BR LATA 250ML FOUR PACK NPAL .;Caixa;1;837;0;6;831
19266;BOHEMIA LT 269ML SH C/15;Caixa;1;81;0;49;32
19266;BOHEMIA LT 269ML SH C/15;Caixa;2;188;0;160;28
19309;TONICA ANTARCTICA GENGIBRE LT 269ML SH C/15;Caixa;2;135;0;11;124
19309;TONICA ANTARCTICA GENGIBRE LT 269ML SH C/15;Caixa;1;90;0;1;89
19321;GUARANA ANTARCTICA ZERO PET 200ML SH C/12;Caixa;1;806;0;13;793
19321;GUARANA ANTARCTICA ZERO PET 200ML SH C/12;Caixa;2;7486;0;576;6910
19668;ORIGINAL LATA 350ML SH C/12 NPAL;Caixa;1;1219;0;2;1217
19668;ORIGINAL LATA 350ML SH C/12 NPAL;Caixa;2;1640;0;21;1619
19729;STELLA ARTOIS LT SLEEK 350ML C 8 CX CARTAO;Caixa;1;610;0;11;599
19729;STELLA ARTOIS LT SLEEK 350ML C 8 CX CARTAO;Caixa;2;3233;0;72;3161
19822;COLORADO SESSION IPA ONE WAY 600ML CX C-12 ARTE;Caixa;1;1;0;0;1
20072;BECKS N LT SLEEK 350ML C 8 CX CARTAO;Caixa;1;549;0;14;535
20072;BECKS N LT SLEEK 350ML C 8 CX CARTAO;Caixa;2;549;0;60;489
20217;ORIGINAL GFA VD 300ML CX C/23;Caixa;1;1775;0;41;1734
20217;ORIGINAL GFA VD 300ML CX C/23;Caixa;2;129;0;10;119
20329;BRAHMA DUPLO MALTE 600ML;Duzia;1;554;0;2;552
20498;BRAHMA DUPLO MALTE LT SLEEK 350ML SH C 12;Caixa;1;2299;0;70;2229
20498;BRAHMA DUPLO MALTE LT SLEEK 350ML SH C 12;Caixa;2;7015;0;75;6940
20530;STELLA ARTOIS 600 ML;Duzia;1;3;0;2;1
20533;BRAHMA DUPLO MALTE GFA VD 1L;Duzia;1;24;0;0;24
20535;STELLA ARTOIS ONE WAY 600ML CX C/12 NPAL;Caixa;1;1;0;0;1
20647;BRAHMA DUPLO MALTE LT 269ML SH C15 NPAL;Caixa;2;207;0;163;44
20647;BRAHMA DUPLO MALTE LT 269ML SH C15 NPAL;Caixa;1;5;0;0;5
20651;CORONA EXTRA N LT SLEEK 350ML C 8 CX CARTAO;Caixa;1;3932;0;5;3927
20651;CORONA EXTRA N LT SLEEK 350ML C 8 CX CARTAO;Caixa;2;1954;0;440;1514
21020;BUDWEISER LT SLEEK 350ML CX CART C 12;Caixa;2;16988;0;63;16925
21020;BUDWEISER LT SLEEK 350ML CX CART C 12;Caixa;1;3806;0;11;3795
21391;AGUA MINERAL S/ GAS AMA PET 1,5L CAIXA C/6 NPAL;Caixa;2;1808;0;19;1789
21391;AGUA MINERAL S/ GAS AMA PET 1,5L CAIXA C/6 NPAL;Caixa;1;555;0;0;555
21441;SUKITA LIMAO PET 2L CAIXA C/6;Caixa;1;9;0;3;6
21441;SUKITA LIMAO PET 2L CAIXA C/6;Caixa;2;0;0;0;0
21501;COLORADO LAGER LN 355ML CX C/12;Caixa;2;0;0;0;0
21501;COLORADO LAGER LN 355ML CX C/12;Caixa;1;15;0;0;15
21526;JOHNNIE WALKER RED LABEL GARRAFA VIDRO 1 L;Unidade;1;1399;0;0;1399
21526;JOHNNIE WALKER RED LABEL GARRAFA VIDRO 1 L;Unidade;2;2098;0;0;2098
21527;TANQUERAY GIN LONDON DRY GARRAFA VIDRO 750ML;Unidade;1;106;0;0;106
21527;TANQUERAY GIN LONDON DRY GARRAFA VIDRO 750ML;Unidade;2;159;0;0;159
21529;ABSOLUT ORIGINAL GARRAFA VIDRO 1 L;Unidade;2;534;0;0;534
21529;ABSOLUT ORIGINAL GARRAFA VIDRO 1 L;Unidade;1;356;0;1;355
21530;SMIRNOFF ORIGINAL GARRAFA VIDRO 998ML;Unidade;1;13844;0;25;13819
21539;JIM BEAM WHITE GARRAFA VIDRO 1 L;Unidade;1;2;0;0;2
21658;SPATEN N LT SLEEK 350ML CX CART C 12;Caixa;1;12858;0;57;12801
21658;SPATEN N LT SLEEK 350ML CX CART C 12;Caixa;2;20739;0;7028;13711
21678;COLORADO INDICA LT SLEEK 350ML C 8 CX CARTAO;Caixa;2;39;0;0;39
21678;COLORADO INDICA LT SLEEK 350ML C 8 CX CARTAO;Caixa;1;9;0;0;9
21778;JOHNNIE WALKER RED LABEL GARRAFA VIDRO 750ML;Unidade;1;15;0;0;15
21778;JOHNNIE WALKER RED LABEL GARRAFA VIDRO 750ML;Unidade;2;23;0;0;23
21788;BALLANTINES FINEST GARRAFA VIDRO 1 L;Unidade;1;27;0;0;27
21788;BALLANTINES FINEST GARRAFA VIDRO 1 L;Unidade;2;41;0;0;41
21789;ORLOFF GARRAFA VIDRO 1 L;Unidade;1;563;0;8;555
21789;ORLOFF GARRAFA VIDRO 1 L;Unidade;2;844;0;0;844
21791;PIRASSUNUNGA 51 GARRAFA VIDRO 965ML;Unidade;1;1;0;0;1
21792;WHITE HORSE GARRAFA VIDRO 1 L;Unidade;1;1361;0;0;1361
21886;BEEFEATER LONDON DRY GARRAFA VIDRO 750ML;Unidade;1;138;0;0;138
21886;BEEFEATER LONDON DRY GARRAFA VIDRO 750ML;Unidade;2;208;0;0;208
21892;NOVECENTO VINHO ARG MALBEC GFA OW 750ML CX C/6;Caixa;1;73;0;0;73
21892;NOVECENTO VINHO ARG MALBEC GFA OW 750ML CX C/6;Caixa;2;109;0;0;109
21894;NOVECENTO VINHO ARG CABERNET SAUVIGNON GFA OW 750ML CX C/6;Caixa;2;268;0;0;268
21894;NOVECENTO VINHO ARG CABERNET SAUVIGNON GFA OW 750ML CX C/6;Caixa;1;179;0;0;179
21898;NOVECENTO ESPUMANTE ARGENTINO BRUT GFA OW 750ML CX C/6 NPAL;Caixa;2;42;0;0;42
21898;NOVECENTO ESPUMANTE ARGENTINO BRUT GFA OW 750ML CX C/6 NPAL;Caixa;1;28;0;0;28
21900;NOVECENTO ESPUMANTE ARGENTINO DULCE GFA OW 750ML CX C/6 NPAL;Caixa;1;102;0;0;102
21900;NOVECENTO ESPUMANTE ARGENTINO DULCE GFA OW 750ML CX C/6 NPAL;Caixa;2;153;0;0;153
21946;ORIGINAL LT 269ML SH C15 NPAL;Caixa;2;11845;0;11509;336
21946;ORIGINAL LT 269ML SH C15 NPAL;Caixa;1;7896;0;36;7860
21955;CHIVAS REGAL 12 ANOS GARRAFA VIDRO 1 L;Unidade;2;274;0;0;274
21955;CHIVAS REGAL 12 ANOS GARRAFA VIDRO 1 L;Unidade;1;182;0;0;182
21968;TRIDENT HORTELA ENVELOPE 8G CX C/21;Caixa;2;2766;0;0;2766
21968;TRIDENT HORTELA ENVELOPE 8G CX C/21;Caixa;1;1844;0;9;1835
21970;TRIDENT MENTA ENVELOPE 8G CX C/21;Caixa;2;27;0;0;27
21970;TRIDENT MENTA ENVELOPE 8G CX C/21;Caixa;1;18;0;6;12
21973;TRIDENT MELANCIA ENVELOPE 8G CX C/21;Caixa;1;8;0;4;4
21974;TRIDENT TUTTI-FRUTTI ENVELOPE 8G CX C/21;Caixa;2;2280;0;0;2280
21974;TRIDENT TUTTI-FRUTTI ENVELOPE 8G CX C/21;Caixa;1;1520;0;6;1514
22003;HALLS CEREJA ENVELOPE 28G CX C/21;Caixa;1;171;0;4;167
22003;HALLS CEREJA ENVELOPE 28G CX C/21;Caixa;2;257;0;0;257
22005;HALLS MENTA ENVELOPE 28G CX C/21;Caixa;1;204;0;2;202
22005;HALLS MENTA ENVELOPE 28G CX C/21;Caixa;2;306;0;0;306
22007;HALLS EXTRA FORTE ENVELOPE 28G CX C/21;Caixa;2;1124;0;0;1124
22007;HALLS EXTRA FORTE ENVELOPE 28G CX C/21;Caixa;1;749;0;25;724
22009;CHICLETE ADAMS HORTELA CAIXINHA 2,8G CX C/100;Caixa;2;206;0;0;206
22009;CHICLETE ADAMS HORTELA CAIXINHA 2,8G CX C/100;Caixa;1;137;0;2;135
22027;COLORADO APPIA LT SLEEK 350ML C8 CX CARTAO NPAL;Caixa;1;3;0;0;3
22027;COLORADO APPIA LT SLEEK 350ML C8 CX CARTAO NPAL;Caixa;2;40;0;11;29
22106;MINI OREO PCT 35G CX C/10;Caixa;1;368;0;1;367
22177;BUDWEISER ZERO LT SLEEK 350ML C 8 CX CARTAO;Caixa;2;395;0;99;296
22177;BUDWEISER ZERO LT SLEEK 350ML C 8 CX CARTAO;Caixa;1;32;0;9;23
22180;BUDWEISER ZERO LONG NECK 330ML SIX-PACK SHRINK C/4;Caixa;1;11;0;11;0
22200;TONICA ANTARCTICA PET 1 L SH C/06;Caixa;2;0;0;0;0
22200;TONICA ANTARCTICA PET 1 L SH C/06;Caixa;1;16;0;1;15
22202;TONICA ANTARCTICA ZERO PET 1L SH C/06;Caixa;2;321;0;311;10
22202;TONICA ANTARCTICA ZERO PET 1L SH C/06;Caixa;1;218;0;1;217
22235;HOEGAARDEN WHITE NAC LT 269ML CX CARTAO C/8 NPAL;Caixa;2;0;0;0;0
22235;HOEGAARDEN WHITE NAC LT 269ML CX CARTAO C/8 NPAL;Caixa;1;16;0;0;16
22249;GOOSE ISLAND MIDWAY NAC LT SLEEK 350ML C 8 CX CARTAO;Caixa;2;47;0;0;47
22249;GOOSE ISLAND MIDWAY NAC LT SLEEK 350ML C 8 CX CARTAO;Caixa;1;11;0;0;11
22259;SUKITA UVA PET 200ML SH C/12;Caixa;1;155;0;9;146
22259;SUKITA UVA PET 200ML SH C/12;Caixa;2;233;0;52;181
22382;PASSPORT SELECTION GARRAFA VIDRO 1 L;Unidade;1;8;0;6;2
22382;PASSPORT SELECTION GARRAFA VIDRO 1 L;Unidade;2;12;0;0;12
22470;HEINZ KETCHUP PCT FP 397G;Unidade;1;864;0;0;864
22470;HEINZ KETCHUP PCT FP 397G;Unidade;2;1297;0;0;1297
22505;JIM BEAM HONEY GARRAFA VIDRO 1 L;Unidade;2;82;0;0;82
22505;JIM BEAM HONEY GARRAFA VIDRO 1 L;Unidade;1;55;0;0;55
22507;JIM BEAM FIRE GARRAFA VIDRO 1 L;Unidade;1;87;0;0;87
22507;JIM BEAM FIRE GARRAFA VIDRO 1 L;Unidade;2;131;0;0;131
22562;DOMECQ COQ. COMPOSTO GARRAFA VIDRO 1 L;Unidade;1;60;0;7;53
22562;DOMECQ COQ. COMPOSTO GARRAFA VIDRO 1 L;Unidade;2;90;0;0;90
23028;BUCHANANS WHISKY DELUXE 12 ANOS GARRAFA VIDRO 1 L;Unidade;2;24;0;0;24
23028;BUCHANANS WHISKY DELUXE 12 ANOS GARRAFA VIDRO 1 L;Unidade;1;16;0;0;16
23029;JOHNNIE WALKER BLACK LABEL GARRAFA VIDRO 1 L;Unidade;1;63;0;0;63
23163;SUKITA TUBAINA PET 2L SHRINK C/6;Caixa;2;61;0;0;61
23163;SUKITA TUBAINA PET 2L SHRINK C/6;Caixa;1;28;0;1;27
23186;SPATEN N 600ML;Duzia;2;147;0;0;147
23186;SPATEN N 600ML;Duzia;1;4084;0;263;3821
23220;PATAGONIA IPA ONE WAY 740ML CX6;Caixa;2;65;0;0;65
23246;PIRACANJUBA LEITE CONDENSADO TETRAPAK 395G CX C/27;Caixa;2;58;0;0;58
23246;PIRACANJUBA LEITE CONDENSADO TETRAPAK 395G CX C/27;Caixa;1;39;0;0;39
23256;PIRACANJUBA CREME DE LEITE TETRAPAK 200G CX C/27;Caixa;2;97;0;0;97
23256;PIRACANJUBA CREME DE LEITE TETRAPAK 200G CX C/27;Caixa;1;64;0;0;64
23269;SKOL BEATS GT LONG NECK 269ML SIX-PACK SH C/4;Caixa;2;36;0;11;25
23269;SKOL BEATS GT LONG NECK 269ML SIX-PACK SH C/4;Caixa;1;42;0;0;42
23271;SKOL BEATS SENSES LONG NECK 269ML SIX-PACK SH C/4;Caixa;2;254;0;1;253
23271;SKOL BEATS SENSES LONG NECK 269ML SIX-PACK SH C/4;Caixa;1;146;0;2;144
23441;SALINAS CRISTALINA CACHACA GARRAFA VIDRO 1 L;Unidade;1;6;0;0;6
23449;MIKES HARD LEMONADE N LT 269ML SH C12 NP;Caixa;1;212;0;0;212
23449;MIKES HARD LEMONADE N LT 269ML SH C12 NP;Caixa;2;212;0;0;212
23450;MIKES HARD LEMONADE PITAIA N LT 269ML SH C12 NP;Caixa;1;8;0;0;8
23463;AGUA MINERAL S/ GAS AMA GFA PET 500ML PACK C/12 NOVO SHAPE;Caixa;1;246;0;0;246
23463;AGUA MINERAL S/ GAS AMA GFA PET 500ML PACK C/12 NOVO SHAPE;Caixa;2;80;0;4;76
23546;INDAIA AGUA MINERAL C/GAS GFA PET 500ML PACK C/12;Caixa;1;1053;0;41;1012
23546;INDAIA AGUA MINERAL C/GAS GFA PET 500ML PACK C/12;Caixa;2;1580;0;10;1570
23548;INDAIA AGUA MINERAL C/GAS GFA PET 330ML FD C/12;Caixa;1;93;0;0;93
23548;INDAIA AGUA MINERAL C/GAS GFA PET 330ML FD C/12;Caixa;2;140;0;0;140
23550;INDAIA AGUA MINERAL S/GAS GFA PET 330ML FD C/12;Caixa;1;186;0;0;186
23550;INDAIA AGUA MINERAL S/GAS GFA PET 330ML FD C/12;Caixa;2;279;0;0;279
23552;INDAIA AGUA MINERAL S/GAS GFA PET 500ML PACK C/12;Caixa;2;870;0;26;844
23552;INDAIA AGUA MINERAL S/GAS GFA PET 500ML PACK C/12;Caixa;1;580;0;49;531
23554;GRAN DANTE MALBEC GFA OW 750ML CX C6;Caixa;2;52;0;0;52
23554;GRAN DANTE MALBEC GFA OW 750ML CX C6;Caixa;1;35;0;0;35
23556;GRAN DANTE BONARDA GFA OW 750ML CX C6;Caixa;2;14;0;0;14
23556;GRAN DANTE BONARDA GFA OW 750ML CX C6;Caixa;1;9;0;0;9
23560;DANTE ROBINO EXTRA BRUT GFA OW 750ML CX C-6;Caixa;1;16;0;0;16
23562;DANTE ROBINO CABERNET SAUVIGNON GFA OW 750ML CX C 6;Caixa;2;177;0;0;177
23562;DANTE ROBINO CABERNET SAUVIGNON GFA OW 750ML CX C 6;Caixa;1;118;0;0;118
23564;DANTE ROBINO MALBEC GFA OW 750ML CX C 6;Caixa;2;161;0;0;161
23564;DANTE ROBINO MALBEC GFA OW 750ML CX C 6;Caixa;1;107;0;0;107
23594;PIRAKIDS BEBIDA LACTEA CHOCOLATE TETRA PAK 200 ML CX C/27;Caixa;2;97;0;0;97
23594;PIRAKIDS BEBIDA LACTEA CHOCOLATE TETRA PAK 200 ML CX C/27;Caixa;1;64;0;0;64
24158;PATAGONIA IPA 600ML;Duzia;1;17;0;0;17
24306;RED BULL MELANCIA LATA 250ML FOUR PACK NPAL;Caixa;1;1178;0;15;1163
24411;QUINTA DO MORGADO VINHO BRANCO SECO GFA VD 750 ML;Unidade;2;873;0;0;873
24411;QUINTA DO MORGADO VINHO BRANCO SECO GFA VD 750 ML;Unidade;1;582;0;0;582
24413;QUINTA DO MORGADO VINHO BORDO MEIO SECO GFA VD 750 ML;Unidade;1;8;0;0;8
24413;QUINTA DO MORGADO VINHO BORDO MEIO SECO GFA VD 750 ML;Unidade;2;12;0;0;12
25151;OLD PARR WHISKY GFA VDR 1L;Unidade;1;91;0;0;91
25151;OLD PARR WHISKY GFA VDR 1L;Unidade;2;136;0;0;136
25303;GARRAFEIRA PL. PRETO BEES 1 UN P/24 GFA 600ML;Unidade;1;781;0;0;781
25546;GARRAFEIRA PL. AL. LAT. AB. PRETA BEES 1 UN P/ 23 GFA 300ML;Unidade;1;847;0;0;847
25700;FUSION PET 2L SHRINK C/6;Caixa;2;0;0;0;0
25700;FUSION PET 2L SHRINK C/6;Caixa;1;15;0;1;14
26204;SPATEN N LT 269ML CX CARTAO C/8 NPAL;Caixa;1;3841;0;41;3800
26204;SPATEN N LT 269ML CX CARTAO C/8 NPAL;Caixa;2;17824;0;64;17760
26607;RED BULL PITAYA LATA 250ML FOUR PACK NPAL;Caixa;1;2305;0;2;2303
26850;LEBRINHA AGUA MINERAL COM GAS GFA PET 500ML PACK C/12;Caixa;2;127;0;0;127
26850;LEBRINHA AGUA MINERAL COM GAS GFA PET 500ML PACK C/12;Caixa;1;84;0;2;82
26862;LEBRINHA AGUA MINERAL SEM GAS GFA PLAST 497ML CX12;Caixa;1;4;0;1;3
26864;LEBRINHA AGUA MINERAL SEM GAS GFA PET 1500ML CX 6;Caixa;2;43;0;0;43
26864;LEBRINHA AGUA MINERAL SEM GAS GFA PET 1500ML CX 6;Caixa;1;28;0;0;28
26936;YPIOCA CONTA GOTAS GOLD GARRAFA VIDRO 965ML;Unidade;1;66;0;23;43
26936;YPIOCA CONTA GOTAS GOLD GARRAFA VIDRO 965ML;Unidade;2;100;0;0;100
27001;GORDONS GIN DRY GFA VD 750 ML;Unidade;1;68;0;0;68
27177;HALLS MENTOL ENVELOPE 28G CX C/21;Caixa;2;218;0;0;218
27177;HALLS MENTOL ENVELOPE 28G CX C/21;Caixa;1;145;0;1;144
27179;HALLS MORANGO ENVELOPE 28G CX C/21;Caixa;1;100;0;6;94
27179;HALLS MORANGO ENVELOPE 28G CX C/21;Caixa;2;150;0;0;150
27375;SAO FRANCISCO CACHACA GARRAFA VD 970ML;Unidade;2;531;0;0;531
27375;SAO FRANCISCO CACHACA GARRAFA VD 970ML;Unidade;1;354;0;35;319
27426;QUERO MOLHO TOMATE TRAD. SACHE 300G CX 24;Caixa;2;12;0;0;12
27426;QUERO MOLHO TOMATE TRAD. SACHE 300G CX 24;Caixa;1;8;0;0;8
27686;MIKES HARD LEMONADE N LONG NECK 275ML SIX PACK SH C/4;Caixa;1;37;0;0;37
27686;MIKES HARD LEMONADE N LONG NECK 275ML SIX PACK SH C/4;Caixa;2;50;0;0;50
27704;MIKES HARD LEMONADE PITAIA N LONG NECK 275ML SIX PACK SH C/4;Caixa;2;15;0;0;15
27704;MIKES HARD LEMONADE PITAIA N LONG NECK 275ML SIX PACK SH C/4;Caixa;1;10;0;0;10
27825;DOMUS CONHAQUE GARRAFA VIDRO 900ML;Unidade;1;1;0;0;1
27866;CORONA CERO SUNBREW N LONG NECK 330 ML SP BASKET CX C4;Caixa;2;168;0;54;114
27866;CORONA CERO SUNBREW N LONG NECK 330 ML SP BASKET CX C4;Caixa;1;26;0;14;12
28137;SKOL BEATS CAIPIRINHA LT 269ML CX CARTAO C/8 NPAL;Caixa;1;3;0;2;1
28512;PEPSI BLACK PET 1,5 SHRINK C/6;Caixa;1;2989;0;5;2984
28512;PEPSI BLACK PET 1,5 SHRINK C/6;Caixa;2;0;0;0;0
28700;OREO ORIGINAL BISCOITO RECHEADO PACOTE 36G CX8;Caixa;1;18;0;6;12
28700;OREO ORIGINAL BISCOITO RECHEADO PACOTE 36G CX8;Caixa;2;28;0;0;28
29197;TANG REFRESCO EM PO LIMAO PCT 18G DP C/18;Caixa;1;82;0;1;81
29197;TANG REFRESCO EM PO LIMAO PCT 18G DP C/18;Caixa;2;123;0;0;123
29199;TANG REFRESCO EM PO LARANJA PCT 18G DP C/18;Caixa;2;112;0;0;112
29199;TANG REFRESCO EM PO LARANJA PCT 18G DP C/18;Caixa;1;74;0;2;72
29201;TANG REFRESCO EM PO ABACAXI PCT 18G DP C/18;Caixa;1;148;0;0;148
29207;TANG REFRESCO EM PO MORANGO PCT 18G DP C/18;Caixa;1;31;0;28;3
29209;TANG REFRESCO EM PO MARACUJA PCT 18G DP C/18;Caixa;1;109;0;5;104
29209;TANG REFRESCO EM PO MARACUJA PCT 18G DP C/18;Caixa;2;164;0;0;164
29215;TANG REFRESCO EM PO UVA PCT 18G DP C/18;Caixa;2;11;0;0;11
29215;TANG REFRESCO EM PO UVA PCT 18G DP C/18;Caixa;1;7;0;0;7
29253;ORIGINAL GFA VD 1L;Duzia;1;302;0;14;288
29460;YVY GIN SECO CONTEMPORANEO AR GFA VD 750 ML;Unidade;1;5;0;0;5
29461;YVY GIN SECO NATIVO TERRA GFA VD 750 ML;Unidade;1;16;0;0;16
29462;YVY GIN SECO CLASSICO MAR GFA VD 750 ML;Unidade;2;668;0;0;668
29462;YVY GIN SECO CLASSICO MAR GFA VD 750 ML;Unidade;1;445;0;0;445
29463;YVY GIN SECO CONTEMPORANEO AR LATA DE ALUMINIO 710ML;Unidade;1;18;0;0;18
29463;YVY GIN SECO CONTEMPORANEO AR LATA DE ALUMINIO 710ML;Unidade;2;27;0;0;27
29474;YVY GIN SECO CLASSICO MAR LATA DE ALUMINIO 710ML;Unidade;1;5;0;1;4
29477;YVY VODKA LATA DE ALUMINIO 710ML;Unidade;1;167;0;0;167
29477;YVY VODKA LATA DE ALUMINIO 710ML;Unidade;2;251;0;0;251
29481;YVY VODKA GFA VD 750 ML;Unidade;1;233;0;0;233
29481;YVY VODKA GFA VD 750 ML;Unidade;2;349;0;0;349
29485;SKOL BEATS CAIPIRINHA LONG NECK 269ML SIX-PACK SH C/4;Caixa;1;138;0;0;138
29485;SKOL BEATS CAIPIRINHA LONG NECK 269ML SIX-PACK SH C/4;Caixa;2;260;0;16;244
29495;GATORADE ZERO CAL FRUTAS SILV PET 350ML SH C12;Caixa;1;288;0;5;283
29503;YVY GIN SECO NATIVO TERRA LATA DE ALUMINIO 710ML;Unidade;2;25;0;0;25
29503;YVY GIN SECO NATIVO TERRA LATA DE ALUMINIO 710ML;Unidade;1;17;0;0;17
29518;JOHNNIE WALKER WHISKY BLONDE GFA VD 750 ML;Unidade;1;112;0;0;112
29518;JOHNNIE WALKER WHISKY BLONDE GFA VD 750 ML;Unidade;2;168;0;0;168
29580;STELLA ARTOIS PURE GOLD LONG NECK 330ML SP SH C/4;Caixa;2;4364;0;696;3668
29580;STELLA ARTOIS PURE GOLD LONG NECK 330ML SP SH C/4;Caixa;1;2055;0;169;1886
29627;QUERO KETCHUP SQUEEZE 400 G;Unidade;2;1185;0;0;1185
29627;QUERO KETCHUP SQUEEZE 400 G;Unidade;1;790;0;0;790
29703;BUDWEISER GFA VD 300ML CX C/23;Caixa;1;756;0;7;749
29733;HALLS MELANCIA ENVELOPE 28G CX C/21;Caixa;1;17;0;8;9
29733;HALLS MELANCIA ENVELOPE 28G CX C/21;Caixa;2;26;0;0;26
29974;SKOL BEATS GT LONG NECK 269ML SIX-PACK SH C/2;Caixa;1;930;0;5;925
29974;SKOL BEATS GT LONG NECK 269ML SIX-PACK SH C/2;Caixa;2;930;0;0;930
29991;SKOL BEATS SENSES LONG NECK 269ML SIX-PACK SH C/2;Caixa;1;165;0;4;161
30045;RED BULL BR LATA 473ML CX C 12;Caixa;1;155;0;0;155
30854;BUBBALOO BALA MIX DISPLAY 15G CX/12;Caixa;1;14;0;0;14
30942;SPATEN N LONG NECK 330ML SIX-PACK SHRINK C/4;Caixa;2;1292;0;50;1242
30942;SPATEN N LONG NECK 330ML SIX-PACK SHRINK C/4;Caixa;1;1493;0;45;1448
31064;BUDWEISER LT 269ML SH C 15;Caixa;2;25466;0;105;25361
31064;BUDWEISER LT 269ML SH C 15;Caixa;1;4359;0;105;4254
31072;QUERO MOLHO DE PIMENTA FRASCO PLAST 150ML;Unidade;2;3437;0;0;3437
31072;QUERO MOLHO DE PIMENTA FRASCO PLAST 150ML;Unidade;1;2291;0;11;2280
31108;MIKES GUARANA N LONG NECK 275ML SIX PACK SH C/4;Caixa;1;130;0;0;130
31108;MIKES GUARANA N LONG NECK 275ML SIX PACK SH C/4;Caixa;2;130;0;0;130
31272;FUSION LT 473ML SH C/12 NPAL;Caixa;1;1;0;0;1
31791;YPE MULTIUSO CLASSICO FRASCO PLAST 500ML CX/12;Caixa;1;7;0;0;7
31791;YPE MULTIUSO CLASSICO FRASCO PLAST 500ML CX/12;Caixa;2;11;0;0;11
31795;BRUTAL FRUIT LONG NECK 275ML SIX PACK SH C 2;Caixa;2;1110;0;40;1070
31795;BRUTAL FRUIT LONG NECK 275ML SIX PACK SH C 2;Caixa;1;639;0;1;638
31875;PIRACANJUBA WHEY MORANGO TETRAPAK 250ML CX C/12;Caixa;1;198;0;1;197
31894;PIRACANJUBA PROTEIN WHEY CHOCOLATE TETRAPAK 250ML CX C/12;Caixa;1;230;0;2;228
31962;FUSION MELANCIA PET 2L SHRINK C/6;Caixa;2;95;0;0;95
31962;FUSION MELANCIA PET 2L SHRINK C/6;Caixa;1;38;0;0;38
32067;GATORADE BERRY BLUE PET 500ML SIXPACK;Caixa;1;165;0;149;16
32067;GATORADE BERRY BLUE PET 500ML SIXPACK;Caixa;2;793;0;386;407
32159;QUERO MOLHO DE ALHO FRASCO PLAST 150ML;Unidade;1;4727;0;0;4727
32164;GUARAVITON NAT ACAI GFA PET 500ML PACK C/12 SP;Caixa;1;4;0;0;4
32169;GUARAVITA NAT COPO PLAST 290ML CX/24 SP;Caixa;2;100;0;0;100
32169;GUARAVITA NAT COPO PLAST 290ML CX/24 SP;Caixa;1;67;0;9;58
32173;GUARAVITON NAT GINSENG GFA PET 500ML PACK C/12 SP;Caixa;2;10;0;5;5
32173;GUARAVITON NAT GINSENG GFA PET 500ML PACK C/12 SP;Caixa;1;7;0;2;5
32355;YPE LAVA LOUCAS LIQUIDO NEUTRO FRASCO PLAST 500ML CX/6;Caixa;2;57;0;0;57
32355;YPE LAVA LOUCAS LIQUIDO NEUTRO FRASCO PLAST 500ML CX/6;Caixa;1;38;0;1;37
32361;BEATS TROPICAL LONG NECK 269ML SIX-PACK SH C/4;Caixa;1;63;0;0;63
32361;BEATS TROPICAL LONG NECK 269ML SIX-PACK SH C/4;Caixa;2;101;0;17;84
32392;CORONA EXTRA N LT 269ML CX CARTAO C/8 NPAL;Caixa;2;300;0;235;65
32392;CORONA EXTRA N LT 269ML CX CARTAO C/8 NPAL;Caixa;1;85;0;29;56
32500;STELLA ARTOIS PURE GOLD LT SLEEK 350ML C 8 CX CARTAO;Caixa;1;97;0;31;66
32500;STELLA ARTOIS PURE GOLD LT SLEEK 350ML C 8 CX CARTAO;Caixa;2;233;0;188;45
32541;RENO VINHO TINTO GFA VD 750 ML;Unidade;1;82;0;0;82
32541;RENO VINHO TINTO GFA VD 750 ML;Unidade;2;123;0;0;123
32543;ALECRIM VINHO TINTO PORTUGAL GFA VD 750 ML;Unidade;2;447;0;0;447
32543;ALECRIM VINHO TINTO PORTUGAL GFA VD 750 ML;Unidade;1;298;0;5;293
32547;CHAC CHAC VINHO BRANCO GFA VD 750 ML;Unidade;1;62;0;0;62
32547;CHAC CHAC VINHO BRANCO GFA VD 750 ML;Unidade;2;93;0;0;93
32549;CHAC CHAC VINHO TINTO MALBEC GFA VD 750 ML;Unidade;2;94;0;0;94
32549;CHAC CHAC VINHO TINTO MALBEC GFA VD 750 ML;Unidade;1;63;0;5;58
32644;BUBBALOO UVA DISPLAY 5G CX/60;Caixa;2;122;0;0;122
32644;BUBBALOO UVA DISPLAY 5G CX/60;Caixa;1;81;0;1;80
32646;BUBBALOO TUTTI FRUTTI DISPLAY 5G CX/60;Caixa;2;72;0;0;72
32646;BUBBALOO TUTTI FRUTTI DISPLAY 5G CX/60;Caixa;1;48;0;2;46
32648;BUBBALOO MORANGO DISPLAY 5G CX/60;Caixa;2;212;0;0;212
32648;BUBBALOO MORANGO DISPLAY 5G CX/60;Caixa;1;141;0;3;138
32749;CORONA EXTRA N 600ML;Duzia;1;1093;0;0;1093
32785;CORONA EXTRA N ONE WAY 600ML GARRAFEIRA C/24;Caixa;1;145;0;3;142
32854;SMIRNOFF ICE LT 269 ML CX C/24;Caixa;1;153;0;3;150
32947;MIKES GUARANA N LT 269ML SH C12 NP;Caixa;2;123;0;0;123
32947;MIKES GUARANA N LT 269ML SH C12 NP;Caixa;1;127;0;0;127
32969;RED BULL SUMMER MORANGO E PESSEGO LATA 250ML FOUR PACK NPAL;Caixa;1;427;0;2;425
33213;DANTE ROBINO LEGADO BLEND DE BLANCAS GARRAFA VD 750ML CX C6;Caixa;1;18;0;0;18
33213;DANTE ROBINO LEGADO BLEND DE BLANCAS GARRAFA VD 750ML CX C6;Caixa;2;27;0;0;27
33214;DANTE ROBINO BONARDA GARRAFA VD 750ML CX C6;Caixa;1;36;0;0;36
33214;DANTE ROBINO BONARDA GARRAFA VD 750ML CX C6;Caixa;2;54;0;0;54
33215;DANTE ROBINO LEGADO BONARDA GARRAFA VD 750ML CX C6;Caixa;1;35;0;0;35
33215;DANTE ROBINO LEGADO BONARDA GARRAFA VD 750ML CX C6;Caixa;2;53;0;0;53
33216;DANTE ROBINO LEGADO MALBEC GARRAFA VD 750ML CX C6;Caixa;1;14;0;0;14
33216;DANTE ROBINO LEGADO MALBEC GARRAFA VD 750ML CX C6;Caixa;2;22;0;0;22
33217;DANTE ROBINO WHITE BLEND GARRAFA VD 750ML CX C6;Caixa;2;36;0;0;36
33217;DANTE ROBINO WHITE BLEND GARRAFA VD 750ML CX C6;Caixa;1;24;0;0;24
33218;DANTE ROBINO LEGADO CABERNET SAUVIGNON GARRAFA VD 750ML CX C;Caixa;2;90;0;0;90
33218;DANTE ROBINO LEGADO CABERNET SAUVIGNON GARRAFA VD 750ML CX C;Caixa;1;60;0;0;60
33219;NOVECENTO VINHO ARG BLEND DE BLANC GARRAFA VD 750 ML CX C6;Caixa;2;573;0;0;573
33219;NOVECENTO VINHO ARG BLEND DE BLANC GARRAFA VD 750 ML CX C6;Caixa;1;382;0;0;382
33220;GRAN DANTE NATURE GFA VD 750ML CX C3;Caixa;2;53;0;0;53
33220;GRAN DANTE NATURE GFA VD 750ML CX C3;Caixa;1;35;0;0;35
33488;HEINZ MOSTARDA SACHE 5G CX C/144;Caixa;1;281;0;1;280
33597;PEPSI BLACK LT 269ML SH C15 NPAL;Caixa;2;5164;0;341;4823
33734;BEATS RED MIX LT 269ML SH C/8;Caixa;2;356;0;236;120
33734;BEATS RED MIX LT 269ML SH C/8;Caixa;1;37;0;8;29
33738;BEATS RED MIX LONG NECK 269ML SIX-PACK SH C/2;Caixa;1;5;0;3;2
34296;TRIDENT CANELA ENVELOPE 8G CX C/21;Caixa;1;3;0;1;2
34296;TRIDENT CANELA ENVELOPE 8G CX C/21;Caixa;2;5;0;0;5
34298;TRIDENT MORANGO ENVELOPE 8G CX C/21;Caixa;2;59;0;0;59
34298;TRIDENT MORANGO ENVELOPE 8G CX C/21;Caixa;1;39;0;4;35
34410;HALLS UVA VERDE ENVELOPE 28G CX C/21;Caixa;2;166;0;0;166
34410;HALLS UVA VERDE ENVELOPE 28G CX C/21;Caixa;1;111;0;4;107
34420;RED BULL SUMMER MARACUJA E MELAO LATA 250ML FOUR PACK NPAL;Caixa;1;777;0;0;777
34429;RED BULL SUGAR FREE AMORA LATA 250ML FOUR PACK NPAL;Caixa;1;777;0;0;777
34770;RED BULL SUGAR FREE POMELO LATA 250ML FOUR PACK NPAL;Caixa;1;777;0;0;777
